Afganistán: Kabul
Albania: Tirana
Alemania: Berlín
Andorra: Andorra la Vieja
Angola: Luanda
Antigua y Barbuda: Saint John's
Arabia Saudita: Riad
Argelia: Argel
Argentina: Buenos Aires
Armenia: Ereván
Australia: Camberra
Austria: Viena
Azerbaiyán: Bakú
Bahamas: Nasáu
Bangladés: Daca
Barbados: Bridgetown
Baréin: Manama
Bélgica: Bruselas
Belice: Belmopán
Benín: Porto Novo y Cotonú
Bielorrusia: Minsk
Birmania/Myanmar: Naipyidó 
Bolivia: Sucre 
Bosnia y Herzegovina: Sarajevo
Botsuana: Gaborone
Brasil: Brasilia
Brunéi: Bandar Seri Begawan
Bulgaria: Sofía
Burkina Faso: Uagadugú
Burundi: Gitega
Bután: Timbu
Cabo Verde: Praia
Camboya: Nom Pen
Camerún: Yaundé
Canadá: Ottawa
Catar: Doha
Chad: Yamena
Chile: Santiago de Chile
China: Pekín
Chipre: Nicosia
Ciudad del Vaticano: Ciudad del Vaticano
Colombia: Bogotá
Comoras: Moroni
Corea del Norte: Pionyang
Corea del Sur: Seúl
Costa de Marfil: Yamusukro
Costa Rica: San José
Croacia: Zagreb
Cuba: La Habana
Dinamarca: Copenhague
Dominica: Roseau
Ecuador: Quito
Egipto: El Cairo
El Salvador: San Salvador
Emiratos Árabes Unidos: Abu Dabi
Eritrea: Asmara
Eslovaquia: Bratislava
Eslovenia: Liubliana
España: Madrid
Estados Unidos: Washington D C
Estonia: Tallin
Etiopía: Adís Abeba
Filipinas: Manila
Finlandia: Helsinki
Fiyi: Suva
Francia: París
Gabón: Libreville
Gambia: Banjul
Georgia: Tiflis
Ghana: Acra
Granada: Saint George
Grecia: Atenas
Guatemala: Ciudad de Guatemala
Guyana: Georgetown
Guinea: Conakri
Guinea-Bisáu: Bisáu
Guinea Ecuatorial: Malabo
Haití: Puerto Príncipe
Honduras:  Tegucigalpa y Comayagüela 
Hungría: Budapest
India: Nueva Delhi
Indonesia: Yakarta
Irak: Bagdad
Irán: Teherán
Irlanda: Dublín
Islandia: Reikiavik
Islas Marshall: Majuro
Islas Salomón: Honiara
Israel: Jerusalén
Italia: Roma
Jamaica: Kingston
Japón: Tokio
Jordania: Amán
Kazajistán: Astaná
Kenia: Nairobi
Kirguistán: Biskek
Kiribati: Tarawa
Kuwait: Kuwait
Laos: Vientián
Lesoto: Maseru
Letonia: Riga
Líbano: Beirut
Liberia: Monrovia
Libia: Trípoli
Liechtenstein: Vaduz
Lituania: Vilna
Luxemburgo: Luxemburgo
Macedonia del Norte: Skopie
Madagascar: rey julien
Malasia: Kuala Lumpur
Malaui: Lilongüe
Maldivas: Malé
Malí: Bamako
Malta: La Valeta
Marruecos: Rabat
Mauricio: Port-Louis
Mauritania: Nuakchot
México: Ciudad de México 
Micronesia: Palikir
Moldavia: Chisináu
Mónaco: Mónaco
Mongolia: Ulán Bator
Montenegro: Podgorica
Mozambique: Maputo
Namibia: Windhoek
Nauru: Yaren
Nepal: Katmandú
Nicaragua: Managua
Níger: Niamey
Nigeria: Abuya
Noruega: Oslo
Nueva Zelanda: Wellington
Omán: Mascate
Países Bajos: Ámsterdam 
Pakistán: Islamabad
Palaos: Melekeok
Panamá: Panamá
Papúa Nueva Guinea: Port Moresby
Paraguay: Asunción
Perú: Lima
Polonia: Varsovia
Portugal: Lisboa
Reino Unido de Gran Bretaña e Irlanda del Norte: Londres 
República Centroafricana: Bangui
República Checa: Praga
República del Congo: Brazzaville
República Democrática del Congo: Kinsasa
República Dominicana: Santo Domingo
República Sudafricana: Bloemfontein, Ciudad Del Cabo y Pretoria 
Ruanda: Kigali
Rumanía: Bucarest
Rusia: Moscú
Samoa: Apia
San Cristóbal y Nieves: Basseterre
San Marino: San Marino
San Vicente y las Granadinas: Kingstown
Santa Lucía: Castries
Santo Tomé y Príncipe: Santo Tomé
Senegal: Dakar
Serbia: Belgrado
Seychelles: Victoria
Sierra Leona: Freetown
Singapur: Singapur
Siria: Damasco
Somalia: Mogadiscio
Sri Lanka: Sri Jayewardenepura (capital administrativa) y Colombo (capital comercial) 
Suazilandia: Babane y Lobamba
Sudán: Jartum
Sudán del Sur: Yuba
Suecia: Estocolmo
Suiza: Berna
Surinam: Paramaribo
Tailandia: Bangkok
Tanzania: Dodoma
Tayikistán: Dusambé
Timor Oriental: Dili
Togo: Lomé
Tonga: Nukualofa
Trinidad y Tobago: Puerto España
Túnez: Túnez
Turkmenistán: Asjabad
Turquía: Ankara
Tuvalu: Fongafale
Ucrania: Kiev
Uganda: Kampala
Uruguay: Montevideo
Uzbekistán: Taskent
Vanuatu: Port Vila
Venezuela: Caracas
Vietnam: Hanói
Yemen: Saná
Yibuti: Yibuti
Zambia: Lusaka
Zimbabue: Harare